################################
##e #  # # ## ### # #  ## # # ##
# # ## #   #      # ##      #  #
# # ##   ##  ## # # #### #### ##
#   ## #    # # # # #    #  # ##
# ###  ## ### # ### # # ## ## ##
#     #   #         # ###      #
## #### # ## # ####    #  ## # #
#  #  ### ## #  # ## #   #   # #
#####     ## ## #    # # ##### #
#     # # #   # # ## # #     #s#
################################
