### ##  ##
 # #
     ##
# # #### #
##   #
#  ## ##
#      #
################
#### # 
  
## ##
## # 